R 1080 680

NO ./odd/wall_4.xpm

WE  ./odd/wall_1.xpm

SO   ./odd/wall_2.xpm

EA ./odd/wall_3.xpm

S      ./odd/sprite_1.xpm

L       ./odd/sprite_2.xpm

F 85, 52, 31

C 104, 192, 220


1111111111111111111111111111
100000000000000001000000001
100000000000000001000010001
100020000300000001030010001
100020000000000001111110001
100000000000002000000000001
100000000000002000000000001
100000020000000000000000001
100000020000000000300000001
100000000000000000000002001
100000000000000000000002001
10000300000000000000W000001
100000000000000000000000001
111111111111111111111111111