R 1080 680

NO ./odd/wall_4.xpm

WE  ./odd/wall_1.xpm

SO   ./odd/wall_2.xpm

EA ./odd/wall_3.xpm

S      ./odd/sprite_1.xpm

L       ./odd/sprite_2.xpm

F 85, 52, 31

C 104, 192, 220


111111111111111111
100000000000000001111011
100000111222000001
1000001 100000000111111111
1002001111000030001
1220000000N00111111111
111111111111111111111
 
 
11111111111111111111
10000000000000001111111111 
100000001111111111
11111111111111111111111111